0,0,1,3,0
1,0,1,3,0
2,1,1,4,0
3,4,0,4,0
4,5,0,5,0
5,6,1,-1,-1