0,0,1,7,0
1,0,1,5,0
2,0,1,5,0
3,1,1,6,0
4,2,1,6,0
5,3,0,7,0
6,3,0,8,0
7,4,0,8,0
8,5,0,9,0
9,7,1,-1,-1