0,0,1,6,0
1,0,1,5,0
2,0,1,7,0
3,1,1,7,0
4,1,1,5,0
5,3,0,6,0
6,4,0,8,0
7,5,0,8,0
8,6,0,9,0
9,7,1,-1,-1