0,0,1,6,0
1,0,1,5,0
2,0,1,5,0
3,0,1,7,0
4,1,1,7,0
5,1,0,6,0
6,2,0,8,0
7,2,0,8,0
8,3,0,9,0
9,5,1,-1,-1