0,0,1,2,0
1,0,1,4,0
2,1,0,4,0
3,1,1,5,0
4,3,0,5,0
5,5,0,6,0
6,7,1,-1,-1