0,0,1,5,0
1,0,1,4,0
2,2,1,3,0
3,4,0,4,0
4,5,0,5,0
5,6,0,6,0
6,7,1,-1,-1