0,1,1,5,-1,0,-1
1,1,1,8,-1,0,-1
2,2,1,5,6,0,0
3,3,1,7,-1,0,-1
4,3,1,6,-1,0,-1
5,3,0,7,-1,0,-1
6,4,0,8,-1,0,-1
7,5,0,9,-1,0,-1
8,5,0,10,-1,0,-1
9,6,1,-1,-1,-1,-1
10,6,1,-1,-1,-1,-1