0,0,1,4,7,0,0
1,1,1,4,-1,0,-1
2,1,1,7,-1,0,-1
3,1,1,8,-1,0,-1
4,2,0,6,-1,0,-1
5,2,1,6,-1,0,-1
6,3,0,9,-1,0,-1
7,4,0,8,-1,0,-1
8,5,0,10,-1,0,-1
9,6,1,-1,-1,-1,-1
10,6,1,-1,-1,-1,-1