0,0,1,5,0
1,0,1,4,0
2,0,1,4,0
3,1,1,8,0
4,1,0,5,0
5,2,0,10,0
6,3,1,8,0
7,3,1,9,0
8,4,0,9,0
9,5,0,11,0
10,5,1,-1,-1
11,6,1,-1,-1