0,0,1,9,0
1,0,1,7,0
2,1,1,6,0
3,3,1,8,0
4,3,1,6,0
5,3,1,7,0
6,4,0,8,0
7,4,0,9,0
8,5,0,10,0
9,5,0,11,0
10,6,1,-1,-1
11,6,1,-1,-1