0,0,1,5,0
1,0,1,5,0
2,1,1,6,0
3,1,1,9,0
4,1,1,8,0
5,1,0,6,0
6,2,0,11,0
7,3,1,8,0
8,4,0,9,0
9,5,0,10,0
10,6,1,-1,-1
11,6,1,-1,-1