0,0,1,2,0
1,1,1,5,0
2,1,0,4,0
3,1,1,4,0
4,2,0,5,0
5,3,0,6,0
6,4,1,-1,-1